8 8 8 8 8 8 8 8
8 0 0 0 0 0 0 1
8 0 3 3 0 0 0 2
8 0 0 3 0 0 0 2
8 0 3 3 0 0 0 2
8 0 0 0 0 0 0 3
8 8 8 8 0 8 8 8
8 8 8 8 8 8 8 8